LINKER	ATCTCTCTCAACAACAACAACGGAGGAGGAGGAAAAGAGAGAGAT
2B4	TGGAGACGGAAGAGAAAGGAGAAGCAATCCGAAACTTCTCCCAAGGAGTTCCTCACCATTTACGAAGATGTAAAGGACCTGAAAACCAGACGGAATCACGAGCAAGAACAGACCTTCCCTGGCGGCGGGTCAACTATCTACTCAATGATCCAGAGTCAAAGTTCTGCTCCAACTAGCCAGGAGCCGGCGTACACGCTTTACAGCCTCATTCAACCTAGCCGCAAAAGCGGCAGCAGGAAGAGAAATCACAGTCCCTCATTCAACAGTACAATCTATGAGGTGATTGGCAAGTCTCAACCAAAAGCCCAGAACCCTGCGCGACTTTCCAGGAAGGAACTCGAGAACTTCGACGTGTACTCC
4-1BB	AAGCGGGGACGCAAGAAGTTGCTCTATATTTTCAAGCAGCCTTTTATGAGACCCGTCCAAACGACACAAGAAGAGGATGGTTGCTCTTGCCGATTTCCAGAGGAAGAAGAAGGAGGTTGCGAACTG
BTLA	CGGCGACACCAGGGTAAGCAAAATGAGCTTTCTGATACAGCCGGCAGGGAAATCAACCTCGTTGACGCCCATCTGAAGTCCGAGCAGACGGAGGCTTCTACGCGCCAGAATTCCCAAGTCCTGTTGTCAGAAACAGGCATCTATGATAATGACCCAGACCTGTGCTTCCGAATGCAGGAAGGTTCTGAAGTCTATAGCAACCCTTGCCTGGAAGAGAACAAACCTGGTATTGTTTACGCGTCCCTCAACCATTCAGTTATCGGACCGAATTCCAGACTTGCTCGGAACGTGAAGGAAGCTCCGACTGAATATGCCAGTATCTGCGTAAGGTCA
CD19	CAAAGAGCCCTGGTCCTGAGGAGGAAAAGAAAGCGAATGACTGACCCCACCAGGAGATTCTTCAAAGTGACGCCTCCCCCAGGAAGCGGGCCCCAGAACCAGTACGGGAACGTGCTGTCTCTCCCCACACCCACCTCAGGCCTCGGACGCGCCCAGCGTTGGGCCGCAGGCCTGGGGGGCACTGCCCCGTCTTATGGAAACCCGAGCAGCGACGTCCAGGCGGATGGAGCCTTGGGGTCCCGGAGCCCGCCGGGAGTGGGCCCAGAAGAAGAGGAAGGGGAGGGCTATGAGGAACCTGACAGTGAGGAGGACTCCGAGTTCTATGAGAACGACTCCAACCTTGGGCAGGACCAGCTCTCCCAGGATGGCAGCGGCTACGAGAACCCTGAGGATGAGCCCCTGGGTCCTGAGGATGAAGACTCCTTCTCCAACGCTGAGTCTTATGAGAACGAGGATGAAGAGCTGACCCAGCCGGTCGCCAGGACAATGGACTTCCTGAGCCCTCATGGGTCAGCCTGGGACCCCAGCCGGGAAGCAACCTCCCTGGCAGGGTCCCAGTCCTATGAGGATATGAGAGGAATCCTGTATGCAGCCCCCCAGCTCCGCTCCATTCGGGGCCAGCCTGGACCCAATCATGAGGAAGATGCAGACTCTTATGAGAACATGGATAATCCCGATGGGCCAGACCCAGCCTGGGGAGGAGGGGGCCGCATGGGCACCTGGAGCACCAGG
CD2	AAAAGAAAAAAGCAAAGAAGCAGGAGGAACGATGAGGAGCTGGAAACCCGAGCGCACCGAGTCGCAACGGAGGAAAGAGGCCGCAAACCGCACCAAATCCCAGCGTCAACGCCACAAAACCCTGCGACATCTCAACACCCACCTCCCCCTCCCGGACATAGAAGCCAGGCCCCTAGTCATCGACCTCCACCTCCCGGCCACCGGGTCCAACACCAGCCGCAAAAACGGCCTCCTGCTCCTTCCGGGACTCAAGTTCATCAACAAAAAGGACCTCCTTTGCCTAGGCCCAGGGTACAGCCAAAACCTCCCCACGGCGCGGCTGAAAATTCACTGAGTCCGTCTTCCAAC
CD22	AAGCTGCAACGGAGATGGAAACGCACCCAAAGTCAACAGGGATTGCAAGAAAATAGTTCCGGTCAGAGTTTCTTCGTACGGAACAAAAAGGTCAGACGGGCACCGCTCTCAGAAGGGCCTCACTCTTTGGGTTGCTACAATCCGATGATGGAGGATGGAATTAGTTATACAACTCTCAGATTTCCAGAGATGAATATCCCCCGAACAGGAGACGCCGAGTCTAGCGAGATGCAGAGACCCCCCCCAGACTGCGACGATACAGTAACGTATAGTGCCCTCCATAAACGGCAAGTCGGAGACTATGAAAACGTAATCCCTGATTTTCCTGAAGACGAGGGAATTCATTATTCTGAACTGATACAATTCGGTGTTGGAGAACGACCTCAGGCACAAGAGAACGTGGACTACGTCATCCTCAAGCAC
CD27	CAGCGCCGAAAGTACAGGTCAAACAAGGGCGAAAGTCCCGTTGAGCCTGCCGAGCCGTGTCACTACTCTTGTCCTCGGGAAGAGGAGGGCTCAACCATCCCAATCCAAGAAGACTACAGGAAGCCCGAGCCAGCTTGTTCTCCC
CD28	CGCTCAAAGCGAAGCCGCCTGTTGCACTCCGATTACATGAATATGACCCCCCGGCGACCTGGCCCGACTCGGAAACATTACCAGCCCTACGCCCCTCCAAGAGATTTCGCAGCCTATCGCTCA
CD30	CACCGCAGGGCGTGCAGGAAACGAATAAGGCAAAAATTGCATTTGTGCTATCCTGTGCAAACTTCTCAGCCCAAACTCGAACTCGTCGACTCACGGCCCAGACGGTCTTCAACTCAACTGAGAAGCGGGGCCTCCGTAACAGAGCCTGTAGCCGAGGAAAGAGGTCTTATGTCCCAGCCGTTGATGGAGACGTGTCACAGTGTCGGCGCCGCTTACCTCGAGTCTCTCCCGCTTCAAGATGCGTCACCGGCAGGTGGCCCGAGTAGCCCTAGAGACCTGCCCGAACCGCGCGTATCAACCGAACATACCAACAACAAGATCGAGAAAATTTACATTATGAAAGCGGATACAGTAATAGTCGGAACCGTCAAAGCCGAGCTTCCCGAAGGGCGCGGTCTGGCAGGTCCCGCAGAACCCGAACTGGAGGAGGAACTCGAGGCTGACCACACTCCACATTATCCTGAACAAGAAACAGAGCCTCCCCTGGGTAGTTGTTCCGACGTAATGCTTAGCGTTGAAGAGGAGGGCAAAGAAGACCCACTGCCAACGGCGGCCTCAGGCAAA
CD3D	GGGCATGAAACGGGACGGTTGAGTGGAGCTGCTGACACACAGGCTTTGCTGAGGAACGACCAGGTATATCAACCACTGCGAGATCGAGACGACGCCCAGTATTCCCACCTCGGTGGCAACTGGGCTAGGAATAAA
CD3E	AAAAATTCTGGCAGCTGAGAAGCCAGTGCATCGCGGGGCGCAGGAGCAGGAGGGAGACAGAGGGGGCAGAATAAGGAAAGGCCCCCACCTGTGCCCAATCCCGATTATGAACCAATTCGGAAAGGCCAAAGGGACCTGTACTCAGGCCTGAATCAACGGAGAATC
CD3G	GGCCAGGACGGGGTCAGGCAGTCTCGCGCATCAGACAAGCAGACGCTCCTCCCAAACGATCAACTTTATCAGCCACTGAAGGATCGGGAGGATGATCAATACTCTCATCTTCAAGGAAATCAGTTGCGAAGAAAT
CD4	TGTGTTCGGTGTAGACACAGGAGAAGGCAGGCTGAGAGAATGTCCCAGATCAAGAGGCTCCTCAGCGAGAAGAAGACGTGTCAGTGCCCACACCGATTCCAGAAGACTTGCAGTCCGATC
CD40	AAGAAGGTGGCCAAAAAGCCGACAAATAAGGCCCCGCACCCTAAACAAGAGCCGCAAGAGATAAATTTCCCAGACGATTTGCCTGGGAGCAACACGGCGGCCCCGGTGCAAGAGACACTGCACGGGTGTCAACCCGTCACCCAAGAAGACGGAAAGGAAAGTCGGATCTCCGTCCAGGAGCGACAG
CD79A	CGGAAACGGTGGCAAAATGAGAAATTGGGCCTTGATGCGGGAGACGAGTATGAAGACGAAAATCTTTATGAAGGACTCAACCTGGATGACTGTTCAATGTACGAAGACATTAGCAGAGGACTCCAGGGGACATACCAGGACGTTGGCAGCCTTAACATAGGGGACGTTCAGTTGGAGAAGCCT
CD79B	TTGGATAAGGACGACTCAAAAGCGGGGATGGAGGAAGATCATACATATGAGGGTCTTGATATAGATCAGACGGCGACCTATGAAGACATCGTTACGCTGAGAACAGGAGAAGTCAAGTGGTCCGTCGGCGAACATCCTGGACAGGAG
CD84	AGACTCTTCAAGCGGAGACAGGGCCGAATCTTTCCCGAGGGTAGCTGCCTCAACACGTTTACCAAGAATCCTTACGCGGCTTCAAAGAAAACGATATACACCTACATTATGGCTAGCCGAAACACTCAACCTGCGGAATCCCGGATATACGACGAGATACTTCAATCAAAGGTACTCCCATCAAAAGAGGAGCCTGTTAATACCGTTTATTCTGAAGTGCAATTCGCAGATAAAATGGGGAAAGCCAGTACCCAAGATAGTAAGCCTCCAGGCACCAGCTCTTACGAAATTGTTATC
CD8A	CTTTACTGCAATCATCGGAACCGCCGGAGGGTGTGCAAATGTCCACGGCCCGTTGTGAAAAGTGGGGACAAACCGTCTTTGTCCGCTCGATATGTA
CD8B	CATCTCTGCTGTCGGAGACGACGAGCAAGGCTGAGGTTCATGAAGCAGTTCTACAAG
CRTAM	ATAATGAAGTTGAGGAAAGCTCACGTTATTTGGAAGAAGGAGAATGAGGTTTCAGAGCACACTCTGGAGAGTTATCGGTCCAGATCCAATAATGAAGAAACCAGCTCAGAAGAGAAAAATGGACAGAGTTCACACCCTATGCGCTGTATGAACTATATAACCAAGCTCTACTCCGAAGCGAAAACCAAGCGAAAAGAGAACGTGCAGCATTCCAAGCTTGAAGAGAAACACATTCAGGTTCCCGAATCCATTGTT
CTLA-4	GCAGTGAGCCTGAGTAAAATGCTTAAAAAACGAAGTCCACTGACTACCGGGGTCTATGTCAAGATGCCACCCACGGAGCCCGAATGCGAAAAACAATTCCAGCCCTACTTCATCCCCATCAAT
DAP12	TACTTTCTGGGCAGATTGGTACCAAGGGGGCGAGGTGCGGCTGAGGCTGCCACACGGAAACAGAGGATAACGGAAACCGAGTCTCCGTATCAGGAACTTCAGGGACAGCGGTCCGATGTTTACAGTGACCTCAACACCCAAAGACCGTACTACAAG
DEGRON10_C51	TTCGCCTGCGTGATCTGCGGCAGAAAGTTCAGAAACAGAGGCCTGATGCAGAAGCACCTGAAGAACCACACAGGGGAAAAACCTTTCAAGTGTCATCTGTGTAATTATGCCTGTCAGAGGCGCGACGCTTTGACGGGTCATCTCCGCACTCAC
DEGRON10_C60	TTCAATGTCTTAATGGTTCATAAGCGAAGCCATACTGGTGAACGCCCATTCGCCTGCGTGATCTGCGGCAGAAAGTTCAGAAACAGAGGCCTGATGCAGAAGCACCTGAAGAACCACACAGGGGAAAAACCTTTTAAGTGTCACCTCTGCAACTATGCATGCCAAAGAAGAGATGCGCTC
DEGRON11_C51	TTCGTGTGCCCTAGATGCGGCAGAGGCTTCAGCCAGCCTAAGAGCCTGGCCAGACACCTGAGACTGCACACAGGGGAAAAACCTTTCAAGTGTCATCTGTGTAATTATGCCTGTCAGAGGCGCGACGCTTTGACGGGTCATCTCCGCACTCAC
DEGRON11_C60	TTCAATGTCTTAATGGTTCATAAGCGAAGCCATACTGGTGAACGCCCATTCGTGTGCCCTAGATGCGGCAGAGGCTTCAGCCAGCCTAAGAGCCTGGCCAGACACCTGAGACTGCACACAGGGGAAAAACCTTTTAAGTGTCACCTCTGCAACTATGCATGCCAAAGAAGAGATGCGCTC
DEGRON12_C51	TTCCAGTGCCCTATCTGCGGCCTGGTGATCAAGAGAAAGAGCTACTGGAAGAGACACATGGTGATCCACACAGGGGAAAAACCTTTCAAGTGTCATCTGTGTAATTATGCCTGTCAGAGGCGCGACGCTTTGACGGGTCATCTCCGCACTCAC
DEGRON12_C60	TTCAATGTCTTAATGGTTCATAAGCGAAGCCATACTGGTGAACGCCCATTCCAGTGCCCTATCTGCGGCCTGGTGATCAAGAGAAAGAGCTACTGGAAGAGACACATGGTGATCCACACAGGGGAAAAACCTTTTAAGTGTCACCTCTGCAACTATGCATGCCAAAGAAGAGATGCGCTC
DEGRON13_C51	TTCCAGTGTAATCAGTGTGGGGACTCTTTTACTCAGAAAGGTAACCTCCTCCGCCACATTAAACTGCACACAGGGGAAAAACCTTTCAAGTGTCATCTGTGTAATTATGCCTGTCAGAGGCGCGACGCTTTGACGGGTCATCTCCGCACTCAC
DEGRON13_C60	TTCAATGTCTTAATGGTTCATAAGCGAAGCCATACTGGTGAACGCCCATTCCAGTGTAATCAGTGTGGGGACTCTTTTACTCAGAAAGGTAACCTCCTCCGCCACATTAAACTGCACACAGGGGAAAAACCTTTTAAGTGTCACCTCTGCAACTATGCATGCCAAAGAAGAGATGCGCTC
DEGRON14_C51	TTCAACTGTAATCAGTGTGGGGCGTCTTTTACTCAGAAAGGTAACCTCCTCCGCCACATTAAACTGCACACAGGGGAAAAACCTTTCAAGTGTCATCTGTGTAATTATGCCTGTCAGAGGCGCGACGCTTTGACGGGTCATCTCCGCACTCAC
DEGRON14_C60	TTCAATGTCTTAATGGTTCATAAGCGAAGCCATACTGGTGAACGCCCATTCAACTGTAATCAGTGTGGGGCGTCTTTTACTCAGAAAGGTAACCTCCTCCGCCACATTAAACTGCACACAGGGGAAAAACCTTTTAAGTGTCACCTCTGCAACTATGCATGCCAAAGAAGAGATGCGCTC
DEGRON1_C51	TTCCAGTGCAACCAGTGCGGCGCCAGCTTCACACAGAAGGGCAACCTGCTGAGACACATCAAGCTGCACACAGGGGAAAAACCTTTCAAGTGTCATCTGTGTAATTATGCCTGTCAGAGGCGCGACGCTTTGACGGGTCATCTCCGCACTCAC
DEGRON1_C60	TTCAATGTCTTAATGGTTCATAAGCGAAGCCATACTGGTGAACGCCCATTCCAGTGCAACCAGTGCGGCGCCAGCTTCACACAGAAGGGCAACCTGCTGAGACACATCAAGCTGCACACAGGGGAAAAACCTTTTAAGTGTCACCTCTGCAACTATGCATGCCAAAGAAGAGATGCGCTC
DEGRON2_C51	TTGCAGTGCGAAATATGCGGCTTTACCTGCCGCCAGAAAGGTAACCTCCTCCGCCACATTAAACTGCACACAGGGGAAAAACCTTTCAAGTGTCATCTGTGTAATTATGCCTGTCAGAGGCGCGACGCTTTGACGGGTCATCTCCGCACTCAC
DEGRON2_C60	TTCAATGTCTTAATGGTTCATAAGCGAAGCCATACTGGTGAACGCCCATTGCAGTGCGAAATATGCGGCTTTACCTGCCGCCAGAAAGGTAACCTCCTCCGCCACATTAAACTGCACACAGGGGAAAAACCTTTTAAGTGTCACCTCTGCAACTATGCATGCCAAAGAAGAGATGCGCTC
DEGRON3_C51	CTGCAGTGCGAGATCTGCGGCTTCACATGCAGACAGAAGGCCAGCCTGAACTGGCACATGAAGAAGCACACAGGGGAAAAACCTTTCAAGTGTCATCTGTGTAATTATGCCTGTCAGAGGCGCGACGCTTTGACGGGTCATCTCCGCACTCAC
DEGRON3_C60	TTCAATGTCTTAATGGTTCATAAGCGAAGCCATACTGGTGAACGCCCACTGCAGTGCGAGATCTGCGGCTTCACATGCAGACAGAAGGCCAGCCTGAACTGGCACATGAAGAAGCACACAGGGGAAAAACCTTTTAAGTGTCACCTCTGCAACTATGCATGCCAAAGAAGAGATGCGCTC
DEGRON4_C51	CTGCAGTGCGAGATCTGCGGCTTCACATGCAGACAGAAGGCCAGCCTGAACTGGCACCAGAGAAAGCACACAGGGGAAAAACCTTTCAAGTGTCATCTGTGTAATTATGCCTGTCAGAGGCGCGACGCTTTGACGGGTCATCTCCGCACTCAC
DEGRON5_C51	CACGAGTGCAAGCTGTGCGGCGCCAGCTTCAGAACAAAGGGCAGCCTGATCAGACACCACAGAAGACACACAGGGGAAAAACCTTTCAAGTGTCATCTGTGTAATTATGCCTGTCAGAGGCGCGACGCTTTGACGGGTCATCTCCGCACTCAC
DEGRON6_C51	CTGCAGTGCGAGGTGTGCGGCTTCCAGTGCAGACAGAGAGCCAGCCTGAAGTACCACATGACAAAGCACACAGGGGAAAAACCTTTCAAGTGTCATCTGTGTAATTATGCCTGTCAGAGGCGCGACGCTTTGACGGGTCATCTCCGCACTCAC
DEGRON7_C51	TACAGATGCAGAGCCTGCGGCAGAGCCTGCAGCAGACTGAGCACACTGATCCAGCACCAGAAGGTGCACACAGGGGAAAAACCTTTCAAGTGTCATCTGTGTAATTATGCCTGTCAGAGGCGCGACGCTTTGACGGGTCATCTCCGCACTCAC
DEGRON8_C51	TACCAGTGCAAGGTGTGCGGCAGAGCCTTCAAGAGAGTGAGCCACCTGACAGTGCACTACAGAATCCACACAGGGGAAAAACCTTTCAAGTGTCATCTGTGTAATTATGCCTGTCAGAGGCGCGACGCTTTGACGGGTCATCTCCGCACTCAC
DEGRON9_C51	CTGCAGTGCGAGATCTGCGGCTACCAGTGCAGACAGAGAGCCAGCCTGAACTGGCACATGAAGAAGCACACAGGGGAAAAACCTTTCAAGTGTCATCTGTGTAATTATGCCTGTCAGAGGCGCGACGCTTTGACGGGTCATCTCCGCACTCAC
DNAM-1	AACCGCCGACGACGACGGGAGAGACGAGACCTGTTCACTGAGTCTTGGGACACTCAAAAGGCTCCCAACAATTACCGCTCTCCGATTTCTACATCTCAACCCACGAATCAAAGCATGGACGACACAAGAGAGGATATTTATGTAAACTATCCTACCTTTTCTCGGCGACCAAAGACTAGGGTA
DR3	ACATACACGTACAGACACTGTTGGCCTCACAAACCACTTGTTACTGCGGATGAAGCTGGAATGGAGGCACTGACACCCCCACCCGCTACGCATCTTTCACCCCTCGACAGCGCCCATACGCTTCTCGCTCCACCTGACTCCTCTGAAAAAATCTGTACCGTCCAGCTCGTTGGTAATAGTTGGACGCCAGGATACCCAGAAACTCAGGAGGCATTGTGCCCACAGGTGACTTGGTCATGGGATCAGTTGCCTAGTAGGGCGCTCGGCCCCGCGGCTGCACCGACACTTTCACCCGAGAGTCCAGCAGGCTCCCCCGCTATGATGCTTCAACCAGGGCCCCAACTTTACGACGTGATGGATGCGGTCCCAGCTCGGAGGTGGAAGGAGTTCGTCCGCACTCTTGGACTCCGAGAGGCTGAGATCGAGGCTGTCGAAGTGGAGATAGGTAGATTTCGGGATCAGCAGTACGAGATGTTGAAAAGGTGGCGGCAGCAGCAACCCGCCGGATTGGGAGCGGTATATGCGGCACTTGAGCGCATGGGTCTGGATGGTTGTGTAGAAGACCTTCGATCCCGATTGCAGAGAGGACCA
EBV_LMP2A	CACTCCGACTACCAGCCACTGGGAACTCAAGACCAGAGTCTGTACCTGGGACTCCGCTGTTGTAGGTACTGTTGCTATTACTGTCTTACCCTGGAGTCTGAGGAACGCCCACCCACCCCATATCGAAATACTGTC
FCER1G	AGGTTGAAGATTCAGGTCCGCAAAGCGGCAATAACGAGCTACGAAAAGTCCGACGGCGTTTATACGGGTCTTAGCACCAGGAACCAAGAGACCTATGAAACATTGAAACATGAAAAACCCCCCCAA
FCGR1A	AGGAAGGAGCTGAAGAGGAAAAAGAAATGGGATCTGGAGATCAGTTTGGACAGTGGTCACGAGAAAAAAGTCATATCTTCTCTGCAAGAAGATCGGCATTTGGAAGAAGAACTCAAGTGTCAGGAACAGAAAGAAGAGCAGTTGCAAGAGGGGGTCCATAGGAAGGAACCGCAAGGTGCAACG
FCGR2A	TGTCGAAAGAAACGCATTAGTGCAAACAGCACTGATCCGGTTAAAGCGGCGCAATTCGAGCCGCCCGGAAGGCAAATGATCGCCATTCGGAAACGCCAACTTGAAGAAACCAACAATGACTACGAGACAGCAGATGGAGGATACATGACGCTCAACCCACGCGCTCCGACTGACGACGATAAGAATATCTATCTCACGCTTCCCCCAAACGATCATGTAAACAGCAATAAT
FCGR2B	GTCGTGGCCCTGATTTACTGTCGCAAAAAGAGGATAAGTGCTCTCCCTGGCTACCCGGAGTGCCGCGAAATGGGCGAAACACTTCCGGAGAAACCGGCGAATCCTACGAATCCGGATGAGGCAGACAAAGTAGGAGCCGAGAATACTATTACTTATAGCCTCCTCATGCACCCAGATGCGCTTGAGGAACCAGACGACCAGAACCGAATT
FCGR3A	AAGACCAACATTAGAAGTAGCACTCGGGACTGGAAAGATCACAAGTTCAAGTGGAGAAAAGATCCTCAAGACAAA
FCRL1	GGACTCAAGAGAAAAATCGGGAGGAGGTCAGCACGAGACCCCCTCAGAAGTCTCCCAAGCCCGCTTCCCCAGGAATTCACTTACCTGAACTCTCCAACACCGGGTCAACTGCAACCTATTTATGAAAACGTAAATGTAGTTTCTGGGGATGAAGTGTATTCCCTGGCATACTACAACCAACCTGAACAGGAGTCCGTGGCAGCAGAGACGCTTGGGACGCACATGGAAGATAAGGTGTCATTGGACATTTACTCCAGGCTTAGAAAAGCTAACATCACCGATGTAGACTATGAAGATGCGATG
FCRL2	CACAAGATCAGCGGCGAATCAAGTGCCACTAACGAACCCAGGGGTGCGTCTCGACCCAATCCTCAGGAGTTCACCTACAGTTCCCCGACTCCAGACATGGAGGAACTTCAACCCGTTTATGTCAATGTAGGAAGCGTTGACGTTGACGTCGTATATTCCCAAGTCTGGAGTATGCAGCAGCCGGAGAGTTCTGCGAATATCAGAACACTTCTGGAGAACAAGGACTCACAAGTAATATATTCCTCCGTGAAGAAGAGC
FCRL3	CATTACGCGCGGGCACGGAGAAAACCCGGAGGTTTGAGTGCAACAGGCACAAGTAGCCACAGCCCCAGTGAGTGTCAGGAGCCATCTAGTTCTAGGCCCAGTAGAATAGATCCACAGGAGCCTACACATTCAAAACCCTTGGCCCCTATGGAGTTGGAGCCTATGTACTCCAATGTTAATCCTGGAGACAGCAATCCAATTTACTCTCAGATTTGGTCAATTCAGCATACTAAGGAAAATTCTGCCAACTGTCCGATGATGCACCAGGAACATGAAGAATTGACCGTACTGTACTCAGAGTTGAAGAAAACCCACCCTGACGATTCCGCTGGTGAGGCGAGTAGCAGAGGACGCGCCCACGAAGAAGACGATGAAGAAAATTATGAGAACGTTCCCCGGGTTCTGCTGGCAAGCGACCAT
FCRL4	CACTGTTGGAGGAGACGCAAATCTGGGGTGGGGTTTTTGGGAGATGAGACAAGACTGCCCCCTGCTCCAGGACCAGGAGAATCCAGTCACTCCATATGTCCTGCCCAAGTTGAGCTGCAAAGCCTCTACGTCGATGTCCATCCTAAGAAAGGTGACCTTGTTTATTCAGAGATACAAACTACGCAGTTGGGCGAAGAAGAAGAGGCCAACACATCCCGAACCCTGCTTGAGGACAAAGACGTTTCTGTGGTCTACAGTGAAGTGAAGACACAGCATCCTGATAACTCAGCGGGCAAAATATCTTCAAAGGACGAGGAATCT
FCRL5	CTCTCTCGGAAAGCGGGCAGGAAACCTGCTTCTGATCCCGCCCGGAGTCCTTCAGACTCTGACTCTCAAGAGCCTACCTATCACAATGTTCCAGCGTGGGAAGAGCTTCAGCCTGTCTACACCAATGCTAATCCGCGCGGGGAAAATGTCGTCTATTCCGAAGTCCGAATAATTCAAGAAAAGAAGAAACATGCAGTAGCGTCTGATCCACGCCACCTGCGAAACAAAGGCTCACCCATAATTTATTCTGAGGTCAAAGTCGCTAGCACACCGGTATCAGGGAGTCTGTTCTTGGCTAGCTCAGCGCCTCACCGC
HHV8_K1	CATTGTCAAAAACAGTCAGACTCAAATAAGACTGTTCCGCAGCAGCTTAGAGATTATTATAGTCTTCACGACCTTTGCACCGAAGATTACACACAACCGGTCGATTGGTAC
HVEM	TGCGTAAAACGAAGAAAACCTCGCGGGGATGTTGTTAAGGTCATAGTGTCCGTGCAGAGAAAGCGCCAGGAGGCCGAGGGAGAGGCAACAGTTATAGAGGCGCTTCAGGCCCCACCGGATGTCACAACCGTCGCTGTCGAAGAAACTATTCCAAGTTTTACAGGAAGGTCTCCAAATCAT
ICOS	TGCTGGCTGACCAAGAAGAAGTACAGTTCAAGCGTCCACGATCCCAATGGCGAGTATATGTTCATGCGAGCGGTCAATACCGCGAAGAAAAGTCGCCTCACCGACGTGACCCTG
IL21R	AGCCTCAAGACGCATCCCCTTTGGAGGCTGTGGAAGAAGATCTGGGCGGTCCCAAGCCCTGAACGATTCTTTATGCCGTTGTACAAAGGCTGCTCTGGCGATTTCAAAAAGTGGGTCGGCGCGCCGTTTACGGGGAGTTCCCTCGAGCTTGGACCATGGTCCCCAGAGGTACCCAGCACGCTCGAAGTCTACAGTTGCCACCCACCGAGGAGTCCAGCTAAGAGGCTTCAGTTGACCGAGTTGCAGGAGCCGGCAGAGCTGGTTGAAAGCGATGGTGTTCCAAAACCCTCTTTTTGGCCAACAGCACAGAATAGTGGGGGAAGCGCGTATAGTGAGGAGCGAGACAGACCATACGGGTTGGTATCAATAGATACAGTGACGGTATTGGACGCTGAAGGGCCTTGTACCTGGCCCTGTAGCTGCGAGGATGACGGCTACCCAGCGCTCGATTTGGATGCCGGACTTGAACCGTCTCCTGGTTTGGAAGATCCATTGCTCGATGCAGGAACGACCGTCTTGTCTTGTGGTTGTGTTAGTGCCGGAAGCCCTGGCTTGGGAGGACCCTTGGGTTCTTTGCTTGACAGGCTCAAGCCCCCATTGGCAGATGGGGAAGATTGGGCTGGGGGTCTTCCCTGGGGGGGAAGGTCTCCTGGGGGTGTCAGTGAAAGCGAGGCTGGATCTCCTCTGGCCGGATTGGATATGGACACATTTGATTCTGGGTTTGTAGGATCAGATTGCAGCTCTCCGGTAGAGTGTGACTTCACGAGCCCGGGCGACGAGGGGCCCCCTCGGTCATACCTCCGGCAATGGGTAGTTATACCTCCTCCCCTGTCCTCACCTGGACCGCAAGCTAGC
IL2RB	AATTGTCGAAACACAGGGCCGTGGTTGAAGAAGGTGTTGAAGTGCAATACTCCGGACCCAAGTAAATTTTTTAGTCAGCTTTCCTCAGAGCACGGCGGCGACGTTCAAAAATGGCTCTCTTCCCCATTTCCCTCCTCCAGCTTCTCACCGGGTGGCCTCGCCCCCGAAATCTCCCCTCTTGAAGTCCTGGAGCGAGACAAGGTCACTCAACTCCTTTTGCAACAGGACAAGGTCCCCGAACCCGCATCTCTTTCTTCCAATCATAGCCTTACATCCTGCTTCACGAATCAGGGATACTTCTTCTTTCATCTGCCAGATGCATTGGAAATAGAGGCGTGCCAAGTTTACTTTACATATGATCCATACTCCGAAGAAGACCCAGACGAGGGCGTAGCCGGAGCCCCTACAGGTTCTTCCCCTCAACCGCTTCAGCCACTCAGCGGGGAAGATGACGCCTACTGCACATTTCCAAGTCGGGATGACCTCCTTCTCTTTTCCCCAAGCCTCCTGGGAGGACCGTCTCCGCCATCTACGGCCCCGGGTGGCTCTGGCGCAGGGGAAGAACGCATGCCGCCGAGCTTGCAGGAGAGAGTTCCTCGGGATTGGGACCCTCAGCCACTGGGTCCACCGACCCCAGGTGTTCCGGACCTTGTAGATTTCCAGCCACCTCCAGAGCTCGTCCTGAGGGAGGCAGGTGAGGAAGTGCCAGATGCCGGTCCGCGGGAAGGCGTATCTTTCCCCTGGAGTCGACCACCCGGTCAGGGTGAGTTTCGGGCCCTGAACGCCCGCCTCCCCCTCAACACCGATGCCTACCTTAGCCTGCAAGAATTGCAGGGCCAAGACCCGACCCACCTTGTC
IL2RG	GAAAGAACCATGCCGCGAATCCCGACTTTGAAGAATCTCGAAGATCTTGTAACTGAGTACCATGGAAATTTCAGTGCCTGGTCTGGGGTCAGCAAGGGGCTTGCGGAAAGCTTGCAACCCGATTACAGTGAAAGACTTTGCTTGGTATCTGAAATACCCCCAAAAGGAGGAGCACTCGGTGAGGGACCCGGCGCATCCCCTTGTAACCAACATAGCCCCTACTGGGCACCTCCCTGCTACACTCTTAAACCCGAAACA
IL7R	AAAAAGAGAATTAAACCGATAGTATGGCCATCACTGCCGGACCATAAAAAGACGCTGGAGCATCTGTGCAAAAAGCCGCGAAAGAACCTGAACGTAAGTTTCAATCCAGAGTCCTTCCTGGACTGCCAAATCCATCGAGTAGACGACATCCAGGCGAGGGACGAAGTCGAAGGGTTCCTTCAAGACACATTTCCTCAACAGTTGGAAGAGTCAGAAAAACAGAGGCTTGGCGGCGATGTCCAATCACCTAACTGTCCATCTGAAGATGTCGTAATTACGCCTGAGAGTTTTGGCAGAGATAGTTCCCTTACTTGCCTCGCTGGCAATGTGAGCGCATGTGACGCCCCTATCCTGAGTTCATCCAGGAGCCTCGATTGCAGAGAGAGTGGAAAGAACGGCCCGCACGTTTATCAAGATTTGCTCCTCAGTCTCGGCACCACGAATTCCACGCTTCCACCTCCTTTTTCTCTCCAAAGCGGAATCCTGACATTGAATCCCGTTGCGCAAGGGCAGCCTATCCTGACAAGTTTGGGGAGCAATCAGGAGGAAGCGTATGTTACTATGAGCAGTTTCTACCAAAATCAG
KIR2DL1	CATAGGTGGTGCAGCAACAAGAAGAATGCAGCAGTGATGGACCAGGAAAGTGCAGGCAATAGAACGGCAAATAGCGAGGATTCCGATGAGCAAGATCCTCAGGAGGTCACTTACACGCAACTGAACCACTGCGTTTTCACACAGCGAAAAATAACACGACCCTCACAACGCCCAAAAACTCCTCCCACTGACATAATAGTATATACAGAACTCCCAAATGCTGAGTCACGCTCCAAGGTGGTAAGCTGCCCC
KIR2DL2	CACCGGTGGTGCAGTAATAAGAAGAATGCAGCAGTCATGGACCAAGAGAGTGCCGGAAATCGCACCGCTAACTCAGAGGATTCAGATGAGCAGGACCCTCAGGAAGTCACCTATACACAACTGAATCACTGTGTCTTTACTCAACGCAAGATCACACGCCCGTCCCAAAGACCAAAGACGCCTCCTACAGACATTATCGTGTATGCCGAGCTGCCTAATGCAGAGAGCCGATCAAAGGTAGTCAGTTGCCCA
KIR2DL3	CACAGATGGTGCTGCAACAAGAAGAACGCAGTAGTTATGGATCAGGAGCCTGCCGGTAATCGCACGGTAAATCGAGAGGATTCCGACGAACAAGATCCCCAGGAAGTCACATACGCCCAGCTGAACCACTGCGTATTCACTCAACGAAAGATAACTCGCCCTAGCCAGAGGCCTAAAACA
KIR2DL5A	CTTCACTGCTGTTGCTCCAATAAAAAAAACGCTGCCGTTATGGATCAAGAACCTGCTGGAGATCGGACCGTTAATAGAGAAGACTCAGATGATCAAGATCCCCAAGAAGTTACCTATGCACAGCTCGATCACTGTGTGTTCACGCAAACCAAGATTACGTCCCCGTCCCAGAGGCCCAAAACTCCTCCGACCGATACTACGATGTATATGGAACTCCCTAACGCGAAGCCGCGCAGCTTGAGCCCGGCACATAAGCACCATTCCCAGGCTCTCAGGGGCTCAAGCAGAGAGACTACGGCCCTCTCTCAGAATAGAGTAGCCTCATCCCACGTCCCTGCTGCTGGTATT
KIR2DL5B	CTCCATTGTTGTTGCAGCAACAAGAAGAATGCGGCTGTAATGGATCAAGGTCCCGCTGGAGACAGAACAGTAAACCGGGAAGATTCCGACGATCAGGACCCTCAAGAAGTTACATACGCCCAGTTGGACCACTGTGTTTTCACACAGACGAAGATCACCTCTCCGTCTCAACGGCCCAAAACCCCGCCGACGGATACTACGATGTATATGGAACTCCCGAACGCCAAACCGAGAAGTCTTTCTCCTGCTCACAAGCATCACAGTCAGGCCCTGAGGGGATCTAGTAGGGAAACAACTGCTTTGTCACAAAACAGAGTAGCTAGTTCCCACGTTCCGGCAGCTGGAATA
KIR3DL1	CACCTGTGGTGTAGCAACAAGAAAAACGCGGCAGTGATGGACCAAGAGCCGGCGGGAAATAGAACGGCAAATTCTGAAGATAGCGATGAACAGGACCCGGAAGAGGTAACTTACGCGCAGTTGGATCATTGCGTTTTCACACAACGCAAGATCACTCGCCCGAGTCAGCGGCCCAAAACCCCTCCGACCGACACGATCCTCTACACGGAACTTCCTAACGCGAAACCCAGGTCAAAAGTGGTTTCCTGTCCC
KIR3DL2	TACCGCTGGTGCAGCAACAAGAAAAACGCGGCGGTAATGGACCAGGAGCCCGCAGGTGACAGAACCGTAAACCGGCAAGACTCCGACGAGCAGGACCCTCAGGAAGTCACTTATGCTCAACTCGATCATTGCGTATTCATACAACGCAAAATCAGCCGCCCAAGTCAGCGCCCTAAGACCCCGTTGACCGACACATCTGTCTATACAGAACTTCCAAACGCGGAGCCTCGCAGTAAAGTCGTGTCCTGTCCGAGAGCTCCACAATCCGGGTTGGAGGGGGTCTTC
KIR3DL3	CATCGCTGGTGCGCCAACAAAAAGAACGCAGTTGTTATGGATCAAGAACCTGCGGGTAACAGAACTGTGAATAGGGAGGATTCTGATGAACAAGATCCCCAGGAAGTTACTTACGCTCAGCTGAACCACTGTGTCTTTACACAACGGAAGATCACTCGACCGTCACAACGGCCCAAGACC
LAG3	CATCTGTGGCGGCGACAGTGGCGACCGCGCAGATTTTCTGCACTCGAACAGGGAATCCACCCGCCCCAAGCGCAGTCAAAAATTGAAGAATTGGAACAAGAGCCGGAACCGGAGCCGGAACCCGAACCAGAGCCTGAACCAGAGCCCGAGCCCGAGCAGTTG
LAT	CATTGTCACAGACTCCCCGGATCTTATGATTCCACGTCTTCAGACTCACTCTATCCCAGGGGGATTCAGTTTAGGCGACCACACACAGTAGCACCGTGGCCTCCTGCATACCCCCCCGTGACTAGCTACCCCCCACTTAGTCAACCGGATTTGCTGCCGATACCCAGGAGCCCTCAACCTTTGGGCGGCAGTCACCGGACGCCCAGCTCTCGGAGGGATAGCGATGGGGCTAACAGCGTGGCGTCATACGAAAACGAGGAGCCCGCTTGCGAGGATGCCGATGAGGACGAAGACGACTACCACAATCCAGGATACCTCGTTGTTCTGCCAGATAGTACCCCAGCAACGAGTACAGCAGCACCTTCAGCGCCGGCCCTTAGCACGCCGGGCATTAGAGACAGTGCCTTCAGCATGGAAAGTATAGACGACTATGTCAACGTCCCAGAGTCTGGGGAGTCAGCTGAAGCCTCATTGGACGGAAGCCGCGAATATGTAAATGTTTCCCAGGAGCTTCATCCAGGGGCGGCCAGGACCGAACCAGCTGCATTGTCCTCTCAGGAAGCGGAGGAGGTAGAGGAGGAGGGTGCCCCAGACTATGAAAATCTGCAGGAGTTGAAT
LILRB1	CTCCGACACAGGCGCCAAGGTAAACACTGGACCAGCACTCAACGAAAAGCGGATTTCCAGCACCCAGCGGGAGCGGTCGGACCCGAGCCAACTGACAGGGGTCTTCAGTGGAGATCCTCTCCAGCGGCTGACGCGCAGGAAGAGAACCTGTATGCCGCTGTAAAACATACCCAGCCTGAGGACGGTGTCGAGATGGATACTCGCTCACCACATGATGAAGATCCGCAAGCCGTTACATATGCAGAGGTAAAACATTCTCGCCCAAGAAGAGAGATGGCAAGTCCTCCGTCCCCCCTGAGCGGAGAGTTTCTCGATACCAAAGATAGACAGGCCGAGGAAGATCGCCAGATGGATACTGAGGCCGCCGCATCAGAGGCACCTCAAGACGTGACCTACGCACAGCTCCACTCTCTCACCTTGCGAAGAGAGGCGACCGAACCCCCGCCCTCCCAAGAAGGACCAAGCCCTGCCGTACCCAGCATATATGCAACCCTTGCGATACAT
LILRB2	CTGAGACATCGACGCCAAGGAAAGCATTGGACATCCACGCAGCGAAAGGCTGACTTTCAGCACCCCGCTGGAGCTGTTGGCCCCGAGCCCACGGATAGGGGTCTTCAATGGAGAAGCAGCCCAGCGGCAGACGCCCAGGAGGAAAATCTGTACGCCGCTGTTAAAGACACTCAGCCTGAGGATGGCGTGGAAATGGATACGAGAGCCGCTGCCTCCGAAGCACCACAGGATGTGACCTACGCTCAACTCCACAGTCTTACATTGCGACGAAAAGCTACTGAACCACCACCGAGTCAGGAAAGAGAGCCTCCTGCGGAGCCCAGTATCTACGCAACTCTTGCCATACAC
LY9	AAGCGAAAAGGGCGGTGTTCAGTTCCCGCCTTCTGTAGCTCTCAGGCCGAGGCACCAGCGGATACTCCTGAACCAACAGCAGGTCATACTTTGTATTCAGTCTTGTCACAGGGATATGAAAAATTGGACACCCCACTGCGGCCTGCTCGGCAGCAACCTACACCTACTTCTGACAGTAGCAGTGATTCTAATCTCACAACCGAAGAAGATGAAGATCGCCCCGAGGTCCACAAGCCGATTAGTGGCCGGTACGAGGTGTTTGACCAGGTGACCCAAGAGGGTGCAGGGCACGATCCGGCCCCGGAAGGGCAAGCGGACTATGACCCCGTGACTCCTTATGTCACCGAAGTCGAGAGCGTCGTAGGTGAAAATACAATGTACGCGCAGGTTTTCAACCTCCAAGGGAAGACTCCGGTTAGTCAGAAGGAGGAGTCTAGTGCTACCATATATTGCAGTATAAGGAAGCCGCAGGTTGTCCCGCCGCCGCAACAGAATGACCTTGAAATACCGGAATCTCCTACCTACGAGAATTTTACA
NKG2A	ATGGACAACCAGGGCGTGATCTACAGCGACCTGAACCTGCCTCCTAATCCTAAGCGGCAGCAGCGGAAGCCGAAGGGCAACAAAAATTCAATCCTGGCCACCGAGCAAGAGATCACCTACGCCGAGCTGAATCTGCAGAAGGCCAGCCAGGACTTCCAGGGCAACGACAAAACCTACCACTGCAAGGACCTGCCTAGCGCTCCTGAGAAA
NKG2C	ATGAGCAAGCAGAGAGGCACCTTCAGCGAGGTGTCCCTGGCTCAGGATCCCAAGAGACAGCAGAGAAAGCCCAAGGGCAACAAGAGCAGCATCAGCGGCACCGAGCAAGAGATCTTCCAGGTGGAACTGAACCTGCAGAACCCCAGCCTGAACCACCAGGGCATCGACAAGATCTACGACTGCCAGGGACTGCTGCCTCCTCCAGAGAAA
NKG2D	ATGGGCTGGATCAGAGGCAGAAGAAGCAGACACAGCTGGGAGATGAGCGAGTTCCACAACTACAACCTGGACCTGAAGAAGTCCGACTTCAGCACCCGGTGGCAGAAACAGAGATGCCCCGTGGTCAAGAGCAAGTGCAGAGAGAATGCCAGC
NKP30	GGGAGTACAGTGTATTACCAAGGGAAGTGTTTGACTTGGAAAGGGCCGAGACGCCAGCTCCCTGCTGTTGTCCCGGCGCCGCTCCCACCGCCCTGCGGCTCTAGCGCACATCTGCTCCCTCCTGTGCCCGGTGGA
NKP44	TGGTGGGGGGACATTTGGTGGAAAACGATGATGGAGCTTAGGAGCCTGGACACGCAAAAAGCTACCTGCCATCTGCAACAAGTAACAGATTTGCCTTGGACCAGTGTATCCTCCCCTGTTGAGCGGGAGATCCTCTATCATACAGTCGCGCGGACGAAGATTAGCGATGATGACGACGAGCATACCTTG
NKP46	CGCAAACGGACCCGAGAACGAGCTTCTAGGGCAAGCACTTGGGAGGGCCGGAGGAGGCTCAACACACAGACATTG
NTB-A	CTCAGGAAACGAAGGGATAGTCTCTCATTGTCAACTCAGCGCACGCAAGGTCCTGCGGAATCAGCGCGAAATCTCGAATATGTTAGTGTTTCTCCCACAAATAATACCGTGTATGCCTCTGTGACCCATTCAAACCGCGAGACGGAAATATGGACACCCCGCGAGAATGACACGATTACAATATACTCCACCATCAATCACTCTAAAGAATCTAAACCAACCTTTTCTAGGGCCACAGCACTTGATAATGTG
OX40	GCACTCTATCTCCTCAGACGGGATCAACGACTCCCGCCTGACGCCCACAAACCACCTGGTGGAGGTTCCTTTCGCACACCGATTCAGGAAGAACAGGCAGACGCTCATTCTACTCTCGCAAAAATC
PD-1	TGTAGCAGAGCAGCTAGAGGGACGATCGGGGCAAGACGAACAGGGCAACCTTTGAAGGAAGATCCTTCCGCTGTCCCTGTGTTTTCTGTAGATTATGGAGAGCTTGACTTTCAATGGAGGGAAAAAACCCCCGAGCCCCCTGTCCCATGCGTACCGGAGCAAACTGAGTACGCCACCATAGTCTTTCCTTCTGGTATGGGTACTTCATCCCCCGCGAGGCGAGGAAGTGCTGACGGCCCTCGAAGTGCCCAGCCGCTGCGCCCGGAAGATGGACACTGCTCTTGGCCACTC
PILRB	TGGTGGCGCAGACGCAAAGGTAGTAGGGCTCCAAGTAGTGATTTT
RRV_R1	CGCTGTAACGAGAATAGTGAGTCTTCTACAAATTCATACGCCTCCCAGACTAGTTATATTCAACCAAGTCACAATCAGAGGAGCAATACTAACGAATGTTCACGACACACTTATCGGAATGCTCATCAAGAGGAGAGCATTGAGGAGCTCCCGAATCAACATACAAGCGAGACTGATTCTTGTTGCCAACTTGTCTTGCTGGAAGTGAAGAACGTAGCTTACGACGGCCCGCAAGAAAACACGATCAACGAAGTAATGGAGCAATACGATGACGTGGTAGTGGAGAACATCGAACAAACGAGTTATGAGGATAATGTAGAACATATGGACTACTCTGATACAATAAACCCGAATTTCAACTACTACTCCGGCCTTATTCTTGAGGAAGTAGACGAGGTTTTCTATAATGAGCTGGAAAATCAATATCACGGACTTATTCTCGAGAACCTGGACCACAATGAATACAATCACCTGAATGAGCTTAACATGATAGAACAATACGATTGGCTTGAG
SIRPA	AGAATAAGGCAGAAGAAGGCCCAGGGATCAACTTCTTCAACCCGACTGCATGAACCAGAAAAGAATGCACGAGAGATCACTCAGGATACAAATGATATTACCTACGCGGACCTCAATTTGCCCAAGGGCAAGAAACCTGCGCCGCAGGCGGCAGAACCCAATAACCATACCGAGTATGCCTCAATACAGACCAGTCCGCAGCCAGCAAGCGAAGACACGCTGACTTACGCTGACCTTGATATGGTACACCTTAATCGAACTCCAAAACAACCAGCGCCAAAACCGGAGCCGAGTTTCAGCGAGTACGCCAGCGTGCAGGTACCGAGAAAG
SLAMF1	CAGCTTCGGCGACGGGGTAAGACGAATCACTATCAGACAACAGTCGAAAAGAAATCTCTTACTATCTATGCACAGGTCCAGAAGCCCGGCCCGCTGCAAAAGAAATTGGACTCATTCCCCGCGCAAGATCCTTGCACGACGATATATGTAGCCGCAACTGAACCAGTACCCGAATCTGTGCAAGAGACTAATTCCATTACTGTATATGCAAGTGTTACTCTCCCCGAATCC
TIGIT	TTGACTAGGAAGAAAAAGGCACTGAGAATACACAGCGTCGAAGGTGATCTGCGGCGCAAGAGCGCGGGCCAGGAGGAATGGTCCCCCAGCGCTCCAAGCCCTCCTGGCTCCTGCGTCCAGGCAGAGGCGGCACCGGCTGGACTGTGTGGGGAGCAAAGAGGCGAAGATTGCGCGGAACTGCATGACTATTTTAACGTCCTGAGCTATCGGTCACTTGGCAACTGCTCATTTTTTACAGAAACCGGA
TIM1	AAGAAGTACTTCTTCAAGAAGGAGGTGCAGCAACTCTCTGTGAGCTTCAGTTCACTTCAAATCAAGGCACTGCAAAACGCCGTAGAAAAGGAGGTTCAAGCCGAGGACAATATATACATCGAAAACAGCCTGTATGCCACCGAC
TIM3	TTCAAGTGGTACAGCCACTCAAAAGAGAAGATTCAAAATCTGTCACTCATCAGTCTTGCTAATCTTCCACCATCCGGGCTTGCAAATGCTGTGGCCGAAGGAATCAGAAGTGAAGAGAACATATATACGATCGAAGAAAATGTGTATGAAGTGGAAGAGCCGAACGAATATTACTGCTATGTTAGTTCCCGCCAGCAGCCCTCTCAGCCACTCGGATGTCGCTTCGCCATGCCT
TLR1	TCATATTTGGACCTTCCGTGGTATCTGAGAATGGTTTGTCAATGGACACAGACGAGGAGAAGGGCGCGCAATATACCTCTCGAAGAACTTCAGCGCAATCTCCAATTTCACGCTTTTATTTCATATTCCGGCCATGATAGCTTCTGGGTTAAAAATGAGCTCCTCCCAAACCTGGAGAAGGAAGGTATGCAGATTTGCCTTCACGAACGGAACTTTGTGCCAGGAAAATCAATAGTGGAGAACATAATAACATGTATCGAGAAAAGCTACAAAAGTATATTCGTGTTGTCTCCGAATTTCGTGCAATCAGAGTGGTGTCATTATGAATTGTACTTCGCCCACCATAATCTGTTTCACGAGGGCAGCAACTCTCTTATTCTTATATTGTTGGAGCCAATACCGCAGTATAGCATTCCCAGCAGCTATCATAAGCTGAAGAGTTTGATGGCTCGGCGAACTTATCTGGAATGGCCTAAGGAAAAGAGCAAAAGAGGACTCTTTTGGGCCAACTTGCGCGCTGCTATAAACATCAAACTCACTGAGCAGGCAAAGAAG
TLR2	CACCGCTTCCACGGCCTGTGGTACATGAAGATGATGTGGGCATGGCTTCAGGCCAAGCGCAAGCCCCGGAAAGCTCCAAGTCGCAATATATGCTACGATGCTTTTGTTTCTTATAGCGAGCGCGATGCTTACTGGGTTGAGAATTTGATGGTCCAGGAATTGGAAAACTTCAATCCACCCTTCAAACTTTGCCTTCATAAGAGAGACTTCATTCCGGGCAAGTGGATTATTGACAATATAATTGATAGTATTGAAAAGTCTCACAAAACCGTCTTTGTGCTTTCAGAGAACTTCGTTAAGTCCGAGTGGTGCAAATATGAGTTGGACTTCAGTCACTTCCGATTGTTCGATGAGAATAACGACGCTGCTATACTGATTTTGCTGGAGCCCATTGAGAAGAAGGCTATCCCCCAGCGCTTCTGCAAATTGAGGAAGATCATGAACACAAAGACATATTTGGAGTGGCCGATGGATGAGGCTCAACGAGAGGGATTTTGGGTAAATCTCAGGGCCGCCATCAAGTCC
TLR3	GAGGGCTGGAGGATTTCCTTTTACTGGAACGTTAGTGTGCATCGGGTTCTCGGCTTCAAAGAGATAGACAGACAAACGGAACAGTTCGAGTATGCTGCTTATATTATTCATGCTTACAAAGATAAGGACTGGGTGTGGGAGCACTTTAGTTCAATGGAAAAGGAGGATCAAAGTTTGAAATTTTGCCTCGAAGAGCGGGATTTCGAGGCCGGGGTATTCGAGCTTGAAGCAATAGTGAACTCAATTAAAAGGTCTAGGAAAATCATTTTCGTTATCACTCACCACCTCCTGAAGGACCCACTTTGTAAGAGGTTCAAAGTTCACCACGCAGTGCAACAAGCTATAGAACAAAACCTCGATTCAATTATACTGGTTTTCCTGGAAGAAATTCCAGACTATAAGCTCAATCACGCTTTGTGTTTGAGACGGGGTATGTTTAAGTCCCATTGCATATTGAATTGGCCGGTGCAAAAAGAACGAATTGGCGCGTTTAGACATAAGCTCCAGGTGGCACTGGGGAGTAAGAATAGCGTGCAC
TLR4	AAGTTCTACTTCCACCTGATGCTGCTGGCTGGCTGTATAAAATACGGTCGAGGTGAAAATATATACGATGCCTTTGTTATCTATTCTAGTCAAGACGAGGACTGGGTTCGCAATGAACTCGTCAAGAATCTTGAGGAGGGCGTACCCCCCTTTCAGTTGTGCTTGCACTATAGAGATTTTATACCGGGAGTGGCTATAGCGGCAAACATAATCCATGAGGGCTTTCACAAGAGCCGAAAGGTCATCGTAGTCGTATCTCAACATTTTATCCAAAGCAGATGGTGTATTTTCGAATACGAGATTGCTCAGACCTGGCAATTCCTCAGTTCCCGCGCAGGCATAATCTTCATAGTGCTCCAAAAGGTGGAGAAGACGTTGCTTCGGCAACAAGTGGAATTGTATCGGCTGCTTTCAAGGAATACCTACCTTGAGTGGGAGGACTCCGTCCTGGGTAGACACATTTTCTGGAGGAGACTCAGGAAGGCGTTGCTTGATGGTAAATCTTGGAATCCAGAGGGTACAGTAGGTACAGGGTGTAACTGGCAGGAGGCCACCTCCATC
TLR5	ACCAAGTTTCGGGGCTTTTGCTTCATCTGCTATAAAACCGCCCAGAGGCTCGTGTTTAAGGACCACCCCCAAGGTACTGAGCCAGATATGTATAAATACGATGCCTACTTGTGTTTCAGTAGTAAAGACTTCACGTGGGTTCAGAACGCACTTCTGAAACATCTGGACACCCAGTATTCTGATCAAAATCGGTTTAACCTCTGCTTCGAGGAACGCGATTTTGTCCCTGGCGAAAATCGCATAGCCAATATCCAAGACGCAATCTGGAATAGCCGGAAAATAGTCTGCCTCGTTTCCCGACATTTCCTGAGAGATGGCTGGTGCTTGGAAGCTTTCTCTTACGCACAGGGTCGGTGTCTCTCTGACCTCAACAGTGCTCTGATAATGGTGGTGGTCGGGAGTCTTTCACAGTATCAGTTGATGAAGCATCAGTCTATCAGAGGATTCGTACAGAAACAACAATACTTGCGATGGCCCGAGGACTTCCAGGACGTTGGTTGGTTTCTCCATAAGCTGAGCCAGCAGATATTGAAGAAAGAAAAGGAAAAAAAGAAAGACAATAATATTCCCCTTCAGACTGTGGCTACGATTAGC
TLR6	TACCTGGATCTGCCCTGGTATTTGCGAATGGTCTGTCAGTGGACACAGACACGACGAAGGGCTCGAAATATTCCACTCGAAGAATTGCAAAGGAATCTGCAATTTCATGCTTTTATTTCTTACTCCGAACACGACTCTGCATGGGTCAAATCTGAGCTTGTTCCTTACTTGGAGAAAGAAGATATACAAATCTGTCTTCATGAAAGAAATTTTGTTCCAGGAAAAAGCATCGTCGAGAACATAATTAACTGTATCGAGAAATCTTACAAATCCATCTTCGTTTTGTCTCCCAATTTCGTCCAAAGCGAGTGGTGCCACTATGAGCTTTACTTTGCCCATCATAACTTGTTTCACGAAGGAAGCAACAACCTCATTTTGATCCTGCTTGAGCCCATTCCCCAAAACTCAATCCCTAATAAGTATCACAAACTGAAAGCCCTGATGACACAACGAACGTATCTTCAGTGGCCGAAAGAGAAGTCAAAACGGGGGCTGTTCTGGGCGAACATTCGGGCTGCGTTTAATATGAAACTGACTCTGGTCACTGAAAATAACGACGTTAAGTCA
TLR7	CATCTGTACTTCTGGGACGTGTGGTACATTTATCACTTCTGTAAGGCAAAAATCAAGGGCTACCAGCGCTTGATTAGCCCCGATTGTTGCTATGACGCTTTTATCGTGTACGATACGAAAGATCCTGCGGTCACTGAATGGGTTCTTGCAGAACTTGTAGCAAAATTGGAGGACCCGCGCGAAAAGCACTTTAATTTGTGCCTCGAAGAGCGGGATTGGTTGCCCGGTCAGCCTGTGCTTGAAAACCTGAGTCAAAGTATTCAATTGTCTAAAAAGACGGTCTTCGTTATGACCGATAAGTACGCCAAAACTGAGAATTTTAAGATTGCGTTCTATCTGAGCCACCAGAGACTCATGGATGAGAAGGTAGACGTGATTATCCTGATTTTTTTGGAGAAACCCTTCCAAAAGTCTAAATTTCTCCAGCTCCGCAAAAGGCTGTGTGGCAGTTCTGTATTGGAATGGCCGACAAATCCTCAAGCACATCCGTATTTCTGGCAGTGCTTGAAAAATGCACTCGCAACAGATAATCACGTTGCGTACTCTCAGGTCTTCAAGGAGACCGTG
